25
10 0 0 0 1 1 0 0 2 2 2
20 1 1 1 1 1 2 2 2 2 2 2 3 3 3 3 3 3 1 1 1
20 3 3 1 1 1 2 2 2 2 2 2 3 3 3 3 3 3 1 1 1
25 3 3 1 1 1 2 2 2 2 2 2 3 3 3 3 3 3 3 3 3 0 1 1 0 0
30 3 3 2 2 2 2 2 3 3 3 2 3 3 3 3 3 3 3 3 3 0 1 0 0 0 1 2 3 0 1
30 3 3 2 2 2 2 2 3 3 3 2 3 3 3 3 3 3 3 3 3 0 1 0 0 0 0 0 0 0 0
30 3 3 2 2 2 2 2 3 3 3 2 3 3 3 3 3 3 3 3 3 0 1 2 0 0 1 2 3 3 3
30 3 3 2 2 2 2 2 3 3 3 2 3 3 3 3 3 3 3 3 3 0 1 2 0 0 1 1 1 0 0
30 3 3 2 2 2 2 2 3 3 3 2 3 3 3 3 3 3 3 3 3 0 1 2 0 0 0 1 2 3 0
30 3 3 2 2 2 2 2 3 3 3 2 3 3 3 3 3 3 3 3 3 0 1 2 0 0 0 1 2 3 0
30 3 3 2 2 2 2 2 3 3 3 2 3 3 3 3 3 3 3 3 3 0 1 2 2 0 0 1 2 3 0
30 3 3 2 2 2 2 2 3 3 3 2 3 3 3 3 3 3 3 3 3 3 1 2 2 0 1 2 1 2 1
30 3 3 2 2 2 2 2 3 3 3 2 3 3 3 3 3 3 3 3 3 3 1 2 2 0 2 2 3 3 0
40 3 3 2 2 2 2 2 3 3 3 2 3 3 3 3 3 3 3 3 3 0 1 2 0 0 1 2 3 3 3 3 3 3 3 3 2 2 2 2 2
40 3 3 2 2 2 2 2 3 3 3 2 3 3 3 3 3 3 3 3 3 0 1 2 0 0 1 2 3 3 3 3 3 3 3 3 2 2 2 2 2
40 3 3 2 2 2 2 2 3 3 3 2 3 3 3 3 3 3 3 3 3 0 1 2 0 0 1 2 3 3 3 3 3 3 3 3 2 2 2 2 2
45 3 3 2 2 2 2 2 3 3 3 2 3 3 3 3 3 3 3 3 3 0 1 2 0 0 1 2 3 3 3 3 3 3 3 3 2 2 2 2 2 3 3 3 3 3
45 3 3 2 2 2 2 2 3 3 3 2 3 3 3 3 3 3 3 3 3 0 1 2 0 0 1 2 3 3 3 3 3 3 3 3 2 2 2 2 2 3 3 3 3 3
50 3 3 2 2 2 2 2 3 3 3 2 3 3 3 3 3 3 3 3 3 0 1 2 0 0 1 2 3 3 3 3 3 3 3 3 2 2 2 2 2 3 3 3 3 3 3 3 3 3 3
50 3 3 2 2 2 2 2 3 3 3 2 3 3 3 3 3 3 3 3 3 0 1 2 0 0 1 2 3 3 3 3 3 3 3 3 2 2 2 2 2 3 3 3 3 3 3 3 3 3 3
50 3 3 2 2 2 2 2 3 3 3 2 3 3 3 3 3 3 3 3 3 0 1 2 0 0 1 2 3 3 3 3 3 3 3 3 2 2 2 2 2 3 3 3 3 3 3 3 3 3 3
55 3 3 2 2 2 2 2 3 3 3 2 3 3 3 3 3 3 3 3 3 0 1 2 0 0 1 2 3 3 3 3 3 3 3 3 2 2 2 2 2 3 3 3 3 3 3 3 3 3 3 2 1 3 2 1
55 3 3 2 2 2 2 2 3 3 3 2 3 3 3 3 3 3 3 3 3 0 1 2 0 0 1 2 3 3 3 3 3 3 3 3 2 2 2 2 2 3 3 3 3 3 3 3 3 3 3 2 1 3 2 1
60 3 3 2 2 2 2 2 3 3 3 2 3 3 3 3 3 3 3 3 3 0 1 2 0 0 1 2 3 3 3 3 3 3 3 3 2 2 2 2 2 3 3 3 3 3 3 3 3 3 3 3 3 1 3 3
