20
5  0 0 0 0 1
10 0 0 0 0 0 0 3 3 2 2
15 0 0 0 0 0 1 1 1 1 2 2 2 2 2 2
15 0 0 0 0 0 0 0 2 2 2 2 2 2 2 2
15 0 0 0 0 0 1 1 1 1 1 3 3 3 3 3
15 0 0 0 0 0 2 2 2 3 3 1 1 1 1 1
20 1 1 1 1 1 1 1 0 0 0 0 3 3 3 3 2 2 2 2 2
20 0 0 0 0 0 0 1 1 1 1 1 1 1 2 2 2 3 3 3 3
20 1 1 1 1 1 2 2 2 2 2 2 3 3 3 3 3 3 1 1 1
25 3 3 1 1 1 2 2 2 2 2 2 3 3 3 3 3 3 1 1 1 3 3 3 3 3
25 3 3 1 1 1 2 2 2 2 2 2 3 3 3 3 3 3 3 3 3 0 1 1 0 0
30 3 3 2 2 2 2 2 3 3 3 2 3 3 3 3 3 3 3 3 3 0 1 0 0 0 1 2 3 0 1
35 3 3 2 2 2 2 2 3 3 3 2 3 3 3 3 3 3 3 3 3 0 1 0 0 0 0 0 0 0 0 2 2 2 2 2
40 3 3 2 2 2 2 2 3 3 3 2 3 3 3 3 3 3 3 3 3 0 1 2 0 0 1 2 3 3 3 3 3 3 3 3 2 2 2 2 2
40 3 3 2 2 2 2 2 3 3 3 2 3 3 3 3 3 3 3 3 3 0 1 2 0 0 1 2 3 3 3 3 3 3 3 3 2 2 2 2 2
40 3 3 2 2 2 2 2 3 3 3 2 3 3 3 3 3 3 3 3 3 0 1 2 0 0 1 2 3 3 3 3 3 3 3 3 2 2 2 2 2
45 3 3 2 2 2 2 2 3 3 3 2 3 3 3 3 3 3 3 3 3 0 1 2 0 0 1 2 3 3 3 3 3 3 3 3 2 2 2 2 2 3 3 3 3 3
45 3 3 2 2 2 2 2 3 3 3 2 3 3 3 3 3 3 3 3 3 0 1 2 0 0 1 2 3 3 3 3 3 3 3 3 2 2 2 2 2 3 3 3 3 3
50 3 3 2 2 2 2 2 3 3 3 2 3 3 3 3 3 3 3 3 3 0 1 2 0 0 1 2 3 3 3 3 3 3 3 3 2 2 2 2 2 3 3 3 3 3 3 3 3 3 3
