06 03 01 01 04 06 06 06 02 06
06 02 06 06 02 06 06 06 02 06
06 02 06 06 02 06 06 06 02 06 
06 02 06 06 02 06 06 06 02 06
06 02 06 06 02 06 06 06 02 06 
06 02 06 06 02 06 06 06 02 06 
06 02 06 06 02 06 03 01 07 06 
06 02 06 06 02 06 02 06 06 06 
06 02 06 06 02 06 02 06 06 06 
06 02 06 06 05 01 07 06 06 06 
