0x00 0x07 0x07 0x02 0x01 0x01 0x01 0x01 0x01 0x03
0x04 0x07 0x07 0x04 0x07 0x07 0x07 0x07 0x07 0x04
0x04 0x07 0x07 0x06 0x03 0x07 0x07 0x07 0x07 0x09
0x04 0x07 0x07 0x07 0x06 0x01 0x03 0x07 0x07 0x07
0x04 0x07 0x07 0x07 0x07 0x07 0x06 0x01 0x01 0x03
0x06 0x03 0x07 0x07 0x07 0x07 0x07 0x07 0x07 0x04
0x07 0x04 0x07 0x02 0x01 0x03 0x07 0x07 0x07 0x04
0x07 0x04 0x07 0x04 0x07 0x06 0x01 0x01 0x01 0x05
0x07 0x04 0x07 0x04 0x07 0x07 0x07 0x07 0x07 0x07
0x07 0x06 0x01 0x05 0x07 0x07 0x07 0x07 0x07 0x07
