8
4 0 0 0 0
1 1
1 0
4 3 3 3 3
4 1 1 1 1
4 0 0 0 0
4 0 1 2 3
2 1 1
