50 06 06 60 06 06 06 06 06 06
02 06 06 02 06 06 06 06 06 06
02 06 06 02 06 06 06 06 06 06
02 06 06 02 06 06 06 06 06 06
02 06 06 02 06 06 06 06 06 06
02 06 06 02 06 06 06 06 06 06
02 06 06 02 06 06 06 06 06 06
02 06 06 05 01 01 01 01 01 04
02 06 06 06 06 06 06 06 06 02
05 01 01 01 01 01 01 01 01 07
