99 06 02 06 06 06 02 06 99 99 00 99 
99 06 02 06 02 06 02 06 99 99 00 99
99 06 02 06 02 06 02 06 99 99 00 99
99 06 02 06 02 06 02 06 99 99 00 99
99 06 02 06 02 06 02 06 99 99 00 99
99 06 02 06 02 06 02 06 99 99 00 99
99 06 06 06 02 06 06 06 99 99 00 99
99 99 99 99 99 99 99 99 99 99 99 99

