99 01 02 01 01 01 02 01 99 99 00 99 
99 01 02 01 02 01 02 01 99 99 00 99
99 01 02 01 02 01 02 01 99 99 00 99
99 01 02 01 02 01 02 01 99 99 00 99
99 01 02 01 02 01 02 01 99 99 00 99
99 01 02 01 02 01 02 01 99 99 00 99
99 01 01 01 02 01 01 01 99 99 00 99
99 99 99 99 99 99 99 99 99 99 99 99

